11111111
10001001
10000001
10000001
10001101
10001101
10001101
11111111
