NO                           ./texture/wassim.xpm





WE./texture/Ali_canape.xpm
EA ./texture/iman.xpm

F 255,100,255






C                          0,0,21



SO     ./texture/bookshelf.xpm

11111111
10000001
100000N1
11111111
